200 900
3000 900
2130 1300 -170 110 0 0 153 255 187 0 100 300 1
100 1100 -130 140 0 0 255 0 122 0 100 300 1
2130 200 80 -200 0 0 111 20 255 0 100 300 1
1130 900 170 170 0 0 100 120 0 0 100 300 1
530 1200 120 -80 0 0 120 0 120 0 100 300 1
730 800 -70 150 0 0 150 0 180 0 100 300 1
1600 900 0 0 0 0 100 200 50 0 200 1000 34
