200 900
3000 900
1300 1500 0 0 0 0 250 0 50 0 200 700 34
1600 1200 0 0 0 0 50 255 150 0 100 700 34
1700 400 0 0 0 0 150 0 150 0 100 700 34
700 900 0 0 0 0 250 255 150 0 250 700 34
1100 300 0 0 0 0 50 155 255 0 100 700 34
2400 1000 0 0 0 0 150 150 250 0 300 700 34
1300 800 0 0 0 0 50 0 150 0 50 700 34
